0=anlam
1= Steve Jobs once famously suggested, "Creativity is just connecting things.
2=ou might create small groups of words that are similar or related to one another
3=A shopping list might be broken down into smaller grouping based on whether the items on the list are vegetables, fruits, dairy or grains
33=As you are creating groupings, look for ways to relate units to each other in meaningful ways.
Marco Polo=Marco Polo travelled through Asia for 24 years from 1271–1295
a continuación=next;then;now
a largo plazo=in the long term
a menudo=often
a treves de=through
a veces=at times
abuelo=dede
acabar=to finish
acceder=to access;agree
aceite=oil
aceptable=acceptable
acercar=to move closer
aclarar=to clarify
acompañar=to accompany
acordase=to remember
acostumbrar=to be used to
actuar=to act;perform
acudir=to come;to turn to
adecuar=to adapt
adquirir=to acquire
afilado=sharp
afuera=outside
agradecer=to thank
ahorrar=to save
al lado de=beside; next to
al ver esto=seeing this
alcanzar=to reach; catch up with
alegre=happy
alejarse=to move away
algo=something
alguien=someone
alguno=some
algunos=a few
alli=there
alrededor=around
alto=tall;high
amable=kind
ambos=both
amorrar=to tie
amplio=wide
andar=to walk
anillo=yüzük
anochecer=to get dark
anterior=previous
apagar=to put out; turn off
apagarse=to burn out; fade away
aparecer= to appear;turn up 
apenas=hardly
aplicar=to apply
aportar=to contribute;provide
apoyo=support
aprender=to learn
aprobar=to approve
aprovechar=to use
aquella=that
aqui=here
armario=wardrobe
arriba=top;upstairs
asegurar=to secure
asiento=seat
asunto=issue
así que=so; therefore
atrapar=to catch
atras=back
aumentar=to increase;enlarge
ausencia=absence
avanzar=advance;proceed
avión=airplane
ayudar=to help
azul=blue
añadir=to add
aún=still
bajar=to lower; to go down
bajo=short;low
banco=bench;seat;bank
barco=boat
bastante=enough
bello=beautiful
boca arriba/abajo=face up/down
bolsillo (el)=pocket
bolso (el)=çanta
brazo (el)=arm
brillo=brilliance
broma=joke
buscar=to look for
caballo=beygir
cabeza=head
cabo (el)=at the end (of the day)
cada=each; every
caerse=to fall
caja=kutu
calcetín=sock
callarse=be quit;shut up
calor=heat
camarero=garson
camino=road; path
camisa=shirt
camiseta=t-shirt
campo=field
cansado=tired
cara=face
casarse=to get married
casi=almost
caso (el)=case
cazar=to hunt
cena=dinner
cereza=cherry
chaqueta=çeket
cierto=certain
ciudad=city
coche=car
cocina=kitchen
coger=to get
colocar=to place;put;plant
comedor=dining room
cometer=to commit; make (an error)
comisaría=police station
como=as; like
como sea=at all costs
compartir=paylaşmak;bölüşmek
componer=to compose;make up
con frecuencia=with frequency; often
conseguir=to get; achieve;obtain;win;reach
constituir= to set up;constitute
construir=construct
contar=to count; to tell
contento=happy
contestar=to answer
contribuir=to contribute
convertirse=convert
corazon=heart
corpulento=corpulent; iri
corredor (el)=runner
cortar=to cut
cortina=curtain
corto=short
crear=to believe
crecer=to grow
cuaderno=defter
cubrir=to cover
cuchillo=knife
cuenta=count
cuidado (el)=care
cuidar=care; look after
cumplir=to comply
cuyo=whose
cuñodo=enişte
da por hecho=take for granted;assume
daño=damage;harm
de acuerdo=all right; okey
de nuevo=again
de vez en cuando=from time to time
deber=to owe
dedo=finger
definir=to define;describe
dejar=to leave
delgado=thin;slim
demasiado=too much
demorar=to delay
dentro=inside; within
dentro de poco=soon
deporte=sport
deportista=sportsman
desarrollar=to develop
desayunar=have a breakfast
descartes=düşünirum oleyse varim
descubrir=to discover
desde=since; from
desde el principio=from the beginning
desear=to desire; want
despacio=slowly
después=after
destacar= to emphasize;detach 
destinar=to allocate
destino=destiny; purpose
detallado=detailed
detenerse=to stop
detras=behind; at the back
deuda=debt
dinero=money
dirigir=to direct
disfrutar=to enjoy
disponer=to arrange
distinguir=to distinguish
divulger=divulge;disclose publicly
dormir=to sleep
dudar=doubt
dueño=owner
durante=during
durar=to last;sürmek
débil=weak
elaborar=ayrıntılı şekilde hazırlamak
elegir=to choose;elect
elevar=to raise;make higher
en=in into for on to at by about
encontrar=to find; encounter
encorgado=incharge
enfadarse=to get angry
enfrente=opposite
enseguida=immediately
enseñar=to teach
entre=between
entrevista=interview
enviar=to send
envio=shipment
es decir=that is to say
esconder=conceal; hide
escuchar=to listen
establecer=to establish
estacion=station
este; esta=this
estrella=star
estudiar=to study
estupendo=great
esté=estar
falda=skirt
falta=lack;absence
faltar=to miss;be missing;be absent
fantasma (el)=ghost
fecha=date
feo=ugly
firmar=to sign
flor=flower
fondo=bottom;end;back
formar=to form;make
friamente=soğukça
fuego=fire
fuego (el)=fire
fuente=fountain;source
fuera=out
fuera de duda=out of doubt
fuerte=strong
funcionar=to work;run
gafas=glasses
ganar=to earn;win;gain
generar=to generate
girar=to turn; spin
gordo=fat;thick;heavy
gorra=siperli şapka
gorro=bere
gran=great; big
grande=big
grano=grain;speck
gritar=to shout
guantes=gloves
guapa=attractive 
guerilla=guerilla
guerra=war
habitación=room
hacha=hatchet
hacia=toward
harto=bıkkın
hay que + verb=one must + verb
hay que ...=one must ...
hegel=trhten ogrnlck en tml drs insnn trhtn drs almdağı
helado=icecream
hogar=home
hueco (el)=space; hollow; hole ;gap
huerto=orchard
huir=to flee; escape
imponer=to impose;force;set
impuesto=tax
impulsado por=powered by
incluir=to include;contain;enclose
incluso=even
iniciar=to initiate
intentar=to try; attemp
interesar=to interest
interino=acting;temporary
interpelar=to question
introducir=to put;insert;introduce
invitar=invite
ir de excursión= to go on a trip
irse=go away; leave
jardin=garden
jersey=sweater
joyas=jewelry
jugar=to play
junto=together; next to
justo=right; fair; just
la bebida=drink
la boca=mouth
la caja=box
la cama=bed
la chimenea=chimney; fireplace
la cosa=thing
la madera=wood
la pagina=page
la pared=wall
la parte=portion; part; side
la respuesta=response
la vez=time
lado=side;place
ladron=thief; burgler
lapiz=pencil
largo=long; length
largo rato=long time
lejos=far
lejos de casa=far from home
ley=law
limpiar=to clean
llamarse=be called
llegar=to arrive
llevar=to carry;to wear
llover=to rain
lograr=to achieve
luchador=fighter
luchar=to fight
luego=than; later
lugar=place; location
luz=light
lámpara=lamp
madera=wood
mancha=stain; leke
mantener=to hold;support;maintain
mantenerse igual=to stay same
manzana=apple
mar (el)=sea
marcado=marked
marcar=to mark
marrón=brown
mas=more
matrimonio=marriage
mayor=bigger
mayoria=majority
mejor=better; best
mejor que nadie=better than anybody
mejorar=to improve;to enhance
mes (el)=month
mesa=table
meter=to put in
mirar=to watch
mochila=backpack
mojada=wet; soaked
molestar=to annoy; bother
moreno=black-skinned
movarse=to move
mudar=to change
mudarse de casa=to move house
mudarse de ropa=o change one’s clothes
mueble=mobilya
muelle=iskele
muelle (el)=1. pier 2.spring
muerto=dead
mujer=woman
más allá=further; beyond
nacer=to be born
nadie=anybody; nobody
naranja=orange
nieto=torun
ningún=none of;any
notar=to notice
novedad=novelty;yenilik
novia=gelin
nuevo=new
nunca=never
obligar=to force
obrero=worker
ocupar=to take up;hold;fill;occupy
ofrecer=to offer
orilla=shore; bank
otra vez=again
pagar=to pay
pais (el)=country
parado=stopped; standing
parar=stop; halt; end
parecer=to seem; look like
pared=wall
parte=part
partir=to cut;break;split;share
pasado mañana=day after tomorow
pasar=to happen;go;pass
pasear=to walk around
pedir=to ask
pelear=to fight
pelo=hair
pensar=to think
pensar en=to think about
peor=worst
pequeno=little
perderse=to get lost
perro=dog
pertenecer=to belong to
pesar= to weigh
pescado=fish yemeği
pescar=to catch;to fish
pez=fish
pierna=leg
pieza=piece
plantear=to suggest;set out;bring up
plazo=term;period
polvo=dust
poner=to put
ponerse=to put on; to set oneself
por fin=at last
por la tarde=in the afternoon
por su parte=on the other
por todos lados=everywhere
posible=possible
preguntar=to ask
pretender=to intend;claim;expect
prever=to predict;foresee
primer=first
primo=cousn
principio (el)=beginning; principle
prisa=hurry
privar=to prevent
probable=probably
probar=prove; test; taste; try
pronto=soon
proponer=to suggest; propose
proporcionar=to provide;supply;adapt
proximo=next
publicar=publish;publicize;divulge
pueblo=village
pájaro=bird
quemar=to burn
querida=darling
queso=cheese
quitar=to remove; take away
quizá=maybe
química=chemistry
rango=rank
rapido=fast; quickly
ratón=rat
razon=reason
recibir=to get
recoger=to collect; gather
reconocer=to recognize
recordar=remind; recall; remember
recostarse=to lie back
recuperar=to recover
referir=işaret etm;ima etm;bahsetmek
regresar=regress
reir=to laugh
relacionar=to connect with
reloj=clock
reordenar=reorder
repetir=repeat
requerir=to require;need
respalder=to back;support
rey=king
rio=river
rio arriba=upstream
robar=to rob
romper=to break; to tear
ropa=clothes
roto=broken
rubio=blonde
ruido (el)=noise
sacar=to take out; remove
sano=healty;sound
saquear=to sack;loot
seguir=to follow;to go on
sentarse=to sit down
servir=to serve
señal=signal
señalar=to show;point
significar=to mean
siguiente=following
silla=iskemle
sin duda=certainly
sin embargo=however
situar=to place; put
sobre=over; on; about
sobrino=yeğen
soler=be used to (do stgh)
solicitar=to request;apply for
soltero=single;unmarried
sombrero=silindir şapka
sonreir=to smile
subir=to get on (a transportation)
subirse a algo=to climb (a unarbol)
sucedir=to happen
sucia=dirty
sucio=dirty
suegro=father-in-law
suelo (el)=floor;ground
sumergirse=submerge; immerse
superar=to overcome;üstesinden gelmek
suponer=to imagine;suppose
tal=such
tambien=also
tampoco=neither
tan pronto como sea posible=as soon as possible
tanto=so much;so many
temer=to fear
tener cuidado=to be carefull
terminar=to end; to finish
terrible=terrible
tienda=shop; tent
tirar=to throw
tocar=to touch; play instrument
todavía=still
trabajador=worker
trabajar=to work
traer=to bring; to carry
tratar=to try
triste=sad
tía=teyze
tío=amca
una vez=once
unir=to unite
uva=grape
vaca=cow
vale=OK
valer=to cost; be worth
vaquero=cowboy;denim
veces=times
vecino=neighbor
venir=to come
verdura=vegetable
vestido=dress
viejo=old
volver=to go back; return
vuelco=turn over
ya=already;zaten
zapatillas=training shoe;terlik
zapato=shoe
zorro=fox
zumo=juice
águila=eagle
éste; ésta=this one
